|||||||||||
|.X|......|
|..|......|
|.o.......|
|||||||||.|
|....oo...|
|.|||||||||
|........P|
|||||||||||