| P |   |   |   |   |   |   |   |   |   |   |   |   |   |   |   |   |   |   | 
  |   |   |   |   |   |   |   |   |   |   |   |   |   |   |   |   |   |   |   
|   |   |   |   |   |   |   |   |   |   |   |   |   |   |   |   |   |   |   | 
  |   |   |   |   |   |   |   |   |   |   |   |   |   |   |   |   |   |   |   
|   |   |   |   |   |   |   |   |   |   |   |   |   |   |   |   |   |   |   | 
  |   |   |   |   |   |   |   |   |   |   |   |   |   |   |   |   |   |   |   
|   |   |   |   |   |   |   |   |   |   |   |   |   |   |   |   |   |   |   | 
  |   |   |   |   |   |   |   |   |   |   |   |   |   |   |   |   |   |   |   
|   |   |   |   |   |   |   |   |   |   |   |   |   |   |   |   |   |   |   | 
  |   |   |   |   |   |   |   |   |   |   |   |   |   |   |   |   |   |   |   
|   |   |   |   |   |   |   |   |   |   |   |   |   |   |   |   |   |   |   | 
  |   |   |   |   |   |   |   |   |   |   |   |   |   |   |   |   |   |   |   
|   |   |   |   |   |   |   |   |   |   |   |   |   |   |   |   |   |   |   | 
  |   |   |   |   |   |   |   |   |   |   |   |   |   |   |   |   |   |   |   
|   |   |   |   |   |   |   |   |   |   |   |   |   |   |   |   |   |   |   | 
  |   |   |   |   |   |   |   |   |   |   |   |   |   |   |   |   |   |   |   
|   |   |   |   |   |   |   |   |   |   |   |   |   |   |   |   |   |   |   | 
  |   |   |   |   |   |   |   |   |   |   |   |   |   |   |   |   |   |   |   
|   |   |   |   |   |   |   |   |   |   |   |   |   |   |   |   |   |   |   | 
  |   |   |   |   |   |   |   |   |   | X |   |   |   |   |   |   |   |   |   
|   |   |   |   |   |   |   |   |   |   |   |   |   |   |   |   |   |   |   | 
  |   |   |   |   |   |   |   |   |   |   |   |   |   |   |   |   |   |   |   
|   |   |   |   |   |   |   |   |   |   |   |   |   |   |   |   |   |   |   | 
  |   |   |   |   |   |   |   |   |   |   |   |   |   |   |   |   |   |   |   
|   |   |   |   |   |   |   |   |   |   |   |   |   |   |   |   |   |   |   | 
  |   |   |   |   |   |   |   |   |   |   |   |   |   |   |   |   |   |   |   
|   |   |   |   |   |   |   |   |   |   |   |   |   |   |   |   |   |   |   | 
  |   |   |   |   |   |   |   |   |   |   |   |   |   |   |   |   |   |   |   
|   |   |   |   |   |   |   |   |   |   |   |   |   |   |   |   |   |   |   | 
  |   |   |   |   |   |   |   |   |   |   |   |   |   |   |   |   |   |   |   
|   |   |   |   |   |   |   |   |   |   |   |   |   |   |   |   |   |   |   | 
  |   |   |   |   |   |   |   |   |   |   |   |   |   |   |   |   |   |   |   
|   |   |   |   |   |   |   |   |   |   |   |   |   |   |   |   |   |   |   | 
  |   |   |   |   |   |   |   |   |   |   |   |   |   |   |   |   |   |   |   
|   |   |   |   |   |   |   |   |   |   |   |   |   |   |   |   |   |   |   | 
  |   |   |   |   |   |   |   |   |   |   |   |   |   |   |   |   |   |   |   
|   |   |   |   |   |   |   |   |   |   |   |   |   |   |   |   |   |   |   | 
  |   |   |   |   |   |   |   |   |   |   |   |   |   |   |   |   |   |   |   
|   |   |   |   |   |   |   |   |   |   |   |   |   |   |   |   |   |   |   | 
  |   |   |   |   |   |   |   |   |   |   |   |   |   |   |   |   |   |   |   
|   |   |   |   |   |   |   |   |   |   |   |   |   |   |   |   |   |   |   | 
  |   |   |   |   |   |   |   |   |   |   |   |   |   |   |   |   |   |   |   
|   |   |   |   |   |   |   |   |   |   |   |   |   |   |   |   |   |   |   | 
  |   |   |   |   |   |   |   |   |   |   |   |   |   |   |   |   |   |   |   
|   |   |   |   |   |   |   |   |   |   |   |   |   |   |   |   |   |   |   | 
  |   |   |   |   |   |   |   |   |   |   |   |   |   |   |   |   |   |   |   
|   |   |   |   |   |   |   |   |   |   |   |   |   |   |   |   |   |   |   | 
  |   |   |   |   |   |   |   |   |   |   |   |   |   |   |   |   |   |   |   
|   |   |   |   |   |   |   |   |   |   |   |   |   |   |   |   |   |   |   | 
  |   |   |   |   |   |   |   |   |   |   |   |   |   |   |   |   |   |   |   
|   |   |   |   |   |   |   |   |   |   |   |   |   |   |   |   |   |   |   | 
  |   |   |   |   |   |   |   |   |   |   |   |   |   |   |   |   |   |   |   
|   |   |   |   |   |   |   |   |   |   |   |   |   |   |   |   |   |   |   | 
  |   |   |   |   |   |   |   |   |   |   |   |   |   |   |   |   |   |   |   
|   |   |   |   |   |   |   |   |   |   |   |   |   |   |   |   |   |   |   | 
  |   |   |   |   |   |   |   |   |   |   |   |   |   |   |   |   |   |   |   
|   |   |   |   |   |   |   |   |   |   |   |   |   |   |   |   |   |   |   | 
  |   |   |   |   |   |   |   |   |   |   |   |   |   |   |   |   |   |   |   
|   |   |   |   |   |   |   |   |   |   |   |   |   |   |   |   |   |   |   | 
  |   |   |   |   |   |   |   |   |   |   |   |   |   |   |   |   |   |   |   
|   |   |   |   |   |   |   |   |   |   |   |   |   |   |   |   |   |   |   | 
  |   |   |   |   |   |   |   |   |   |   |   |   |   |   |   |   |   |   |   
|   |   |   |   |   |   |   |   |   |   |   |   |   |   |   |   |   |   |   | 
  |   |   |   |   |   |   |   |   |   |   |   |   |   |   |   |   |   |   |   
|   |   |   |   |   |   |   |   |   |   |   |   |   |   |   |   |   |   |   | 
  |   |   |   |   |   |   |   |   |   |   |   |   |   |   |   |   |   |   |   
|   |   |   |   |   |   |   |   |   |   |   |   |   |   |   |   |   |   |   | 
  |   |   |   |   |   |   |   |   |   |   |   |   |   |   |   |   |   |   |   
|   |   |   |   |   |   |   |   |   |   |   |   |   |   |   |   |   |   |   | 
  |   |   |   |   |   |   |   |   |   |   |   |   |   |   |   |   |   |   |   
|   |   |   |   |   |   |   |   |   |   |   |   |   |   |   |   |   |   |   | 
  |   |   |   |   |   |   |   |   |   |   |   |   |   |   |   |   |   |   |   
|   |   |   |   |   |   |   |   |   |   |   |   |   |   |   |   |   |   |   | 
  |   |   |   |   |   |   |   |   |   |   |   |   |   |   |   |   |   |   |   
|   |   |   |   |   |   |   |   |   |   |   |   |   |   |   |   |   |   |   | 
  |   |   |   |   |   |   |   |   |   |   |   |   |   |   |   |   |   |   |   
|   |   |   |   |   |   |   |   |   |   |   |   |   |   |   |   |   |   |   | 
  |   |   |   |   |   |   |   |   |   |   |   |   |   |   |   |   |   |   |   
|   |   |   |   |   |   |   |   |   |   |   |   |   |   |   |   |   |   |   | 
