|||||||||||
|.X.......|
|.........|
|.o.......|
|..oo.....|
|....oo...|
|......oo.|
|........P|
|||||||||||