|||||||||||||||||||||||||||||||||||||||
| P |   |   |   |   |   |   |   |   | |
| |   |   |   |   |   |   |   |   |   |
|   |   |   |   |   |   |   |   |   | |
| |   |   |   |   |   |   |   |   |   |
|   |   |   |   |   |   |   |   |   | |
| |   |   |   |   |   |   |   |   |   |
|   |   |   |   |   |   |   |   |   | |
| |   |   |   |   |   |   |   |   |   |
|   |   |   |   |   |   |   |   |   | |
| |   |   |   |   |   |   |   |   |   |
|   |   |   |   |   |   |   |   |   | |
| |   |   |   |   |   | X |   |   |   |
|   |   |   |   |   |   |   |   |   | |
| |   |   |   |   |   |   |   |   |   |
|   |   |   |   |   |   |   |   |   | |
| |   |   |   |   |   |   |   |   |   |
|   |   |   |   |   |   |   |   |   | |
|||||||||||||||||||||||||||||||||||||||
