ooo|ooo|ooo|ooo|ooo|ooo|ooo|ooo|o
o|ooo|ooo|ooo|ooo|ooo|ooo|ooo|ooo
ooo|ooo|ooo|ooo|ooo|ooo|ooo|ooo|o
o|ooo|ooo|ooo|ooo|ooo|ooo|ooo|ooo
ooo|ooo|oPo|ooo|ooo|ooo|ooo|ooo|o
o|ooo|ooo|ooo|ooo|ooo|ooo|ooo|ooo
ooo|ooo|ooo|ooo|ooo|ooo|ooo|ooo|o
o|ooo|ooo|ooo|ooo|ooo|ooo|ooo|ooo
ooo|ooo|ooo|ooo|ooo|ooo|ooo|ooo|o
o|ooo|ooo|ooo|ooo|ooo|ooo|ooo|ooo
ooo|ooo|ooo|ooo|ooo|ooo|ooo|ooo|o
o|ooo|ooo|ooo|ooo|ooo|ooo|ooo|ooo
ooo|ooo|ooo|ooo|ooo|ooo|ooo|ooo|o
o|ooo|ooo|ooo|ooo|ooo|ooo|ooo|ooo
ooo|ooo|ooo|ooo|ooo|ooo|ooo|oXo|o
o|ooo|ooo|ooo|ooo|ooo|ooo|ooo|ooo
