   |   |   |   | 
 |   |   |   |   
 P |   |   |   | 
 |   |   |   |   
   |   |   |   | 
 |   |   |   |   
   |   | X |   | 
 |   |   |   |   
   |   |   |   | 
 |   |   |   |   
