||||||||||||||||||||||||||||
.....||..............||.....
||||.||.||||||||||||.||.||||
||||.||.||||||||||||.||.||||
||||....||........||....||||
||||.||.||.||||||.||.||.||||
||||.||....||||||....||.||||
.....||.||.||||||.||.||.....
|.||.||.||........||.||.||.|
|.||.||.||||||||||||.||.||.|
|.||.||.||||||||||||.||.||.|
|..........................|
|.|||||||.||||||||.|||||||.|
|.|||||||.||||||||.|||||||.|
|.||......||||||||......||.|
|.||.||||.||||||||.||||.||.|
|....||||.||||||||.||||....|
|||||||..............|||||||
|||||||.||||||||||||.|||||||
|.......||||||||||||.......|
|.|||.||||........||||.|||.|
|.|||.||||.||||||.||||.|||.|
|.......||.||||||.||.......|
|||||||.||........||.|||||||
|||||||.||.||||||.||.|||||||
|....||.||.||||||.||.||....|
|.||.||.||........||.||.||.|
|.||....||.||||||.||....||.|
|.||.||.||.||||||.||.||.||.|
|....||..............||....|
||||||||||||||||||||||||||||